"","exam.one","exam.two","exam.three","exam.four","totalpoints","average.score"
"1",85,85,89,94,353,132.375
"2",80,75,88,93,336,126
"3",95,90,93,98,376,141
"4",72,78,82,87,319,119.625
"5",88,85,90,95,358,134.25
"6",88,88,93,98,367,137.625
"7",90,88,92,97,367,137.625
"8",79,81,85,90,335,125.625
"9",59,67,73,78,277,103.875
"10",99,97,100,105,401,150.375
"11",86,87,90,95,358,134.25
"12",86,85,80,85,336,126
"13",93,90,97,102,382,143.25
"14",90,89,91,96,366,137.25
